1111111
100E001
1100001
100C001
1P00C01
1000V01
1111111
