1111111111
100E0001C1
1100000101
100C000001
1P00C000V1
100V000001
1111111111
