1111110
100E001
1100001
100C001
1P00C01
100V001
1111111
